0000000000000000000
0000000000000000000
0000000000000000000
0000000000000000000
0000000422250000000
0000000000000000000
2500000000000000042
3122222222222222213
3333333333333333333
3333333333333333333
3333333333333333333
3333333333333333333
3333333333333333333